1111111
1100001
101E101
1010101
11C00P1
1001101
1111111
